108,108,108,108,63,108,108,108,108,108,108,108,63,108,108,108,108,108,108,108,108,108,108,108,282
282,108,108,108,63,108,108,108,282,108,108,108,63,282,108,108,108,115,116,108,282,108,282,108,108
108,108,282,108,63,63,108,108,108,108,108,108,63,108,108,108,108,108,63,63,108,108,108,108,108
108,108,108,108,63,63,63,63,108,108,108,63,63,108,108,63,63,63,63,63,108,108,108,108,108
108,108,108,108,108,108,108,63,63,63,63,63,63,63,63,63,63,108,108,63,108,108,282,108,282
108,282,108,108,108,108,108,108,108,282,108,108,108,282,108,108,108,108,108,63,282,108,108,108,108
108,108,108,108,108,108,108,282,108,108,108,108,108,108,108,108,108,282,108,63,108,108,108,108,153
63,63,63,63,63,63,63,63,63,63,63,63,63,108,108,108,108,108,63,63,63,108,108,108,161
108,108,108,108,108,108,108,108,108,282,108,108,63,63,63,63,63,63,63,63,63,63,63,63,63
108,108,282,108,108,115,116,108,282,108,108,108,108,108,108,108,108,108,108,63,108,108,108,108,108
108,108,108,108,108,108,108,108,108,108,115,116,108,282,108,108,282,108,108,63,108,108,282,108,282
108,108,153,108,108,108,108,108,108,108,108,108,108,108,108,108,108,108,63,63,108,108,108,108,108
108,108,161,108,108,108,108,108,108,63,63,63,63,63,63,63,63,63,63,63,282,108,108,282,108
282,108,282,108,108,108,108,108,108,108,108,108,108,108,108,108,115,116,108,108,108,108,108,108,108
108,108,108,108,108,108,108,108,108,108,108,108,282,108,108,108,108,282,108,108,108,108,108,108,282
