0,0,0,0,0,0,0,0,0,0,0,0,0,0,0,0,0,0,0,0,0,0,0,0,0
0,0,0,0,0,0,0,0,0,0,0,0,0,0,0,0,0,0,0,0,0,0,0,0,0
0,0,0,0,0,0,0,0,0,0,0,0,0,0,0,0,0,0,0,0,0,0,0,0,0
0,0,0,0,0,0,0,0,0,0,0,0,0,0,0,0,0,0,0,0,0,0,0,0,0
0,0,0,0,0,0,0,0,0,0,0,0,0,0,0,0,0,0,0,0,0,0,0,0,0
0,0,0,0,0,0,223,223,223,223,223,223,223,223,223,223,223,223,223,0,0,0,0,0,0
223,223,223,223,223,223,223,223,223,223,223,223,223,223,223,223,223,223,223,223,0,0,0,0,0
223,223,223,223,223,223,223,0,0,0,0,0,0,0,0,0,0,223,223,223,0,0,0,0,0
223,0,0,0,0,0,0,0,0,0,0,0,0,0,0,0,0,0,223,223,223,223,223,223,223
223,0,0,0,0,0,0,0,0,0,0,0,0,0,0,0,0,0,223,223,223,223,223,223,223
223,0,0,0,0,0,0,0,0,0,0,0,0,0,0,0,0,0,0,0,0,0,0,0,0
223,0,0,0,0,0,0,0,0,0,223,223,223,223,223,0,0,0,0,0,0,0,0,0,0
223,0,0,0,0,0,0,0,0,0,223,223,223,223,223,0,0,0,0,0,0,0,0,0,0
223,223,223,223,223,0,223,223,223,223,223,223,223,223,223,223,223,223,223,223,223,223,223,223,223
223,223,223,223,223,0,223,223,223,223,223,223,223,223,223,223,223,223,223,223,223,223,223,223,223
